1;1;5100;1;
1;1;5500;0;
1;1;6200;1;
1;1;6300;1;
1;1;6300;0;
1;1;6800;1;
1;1;7800;0;
1;1;8000;1;
2;1;8000;1;9000;
1;1;9000;1;
