1;1;5000;1;
1;1;5500;1;
1;1;6000;1;
1;1;6500;1;
1;1;7000;1;
1;1;7500;1;
1;1;8000;1;
1;1;8500;1;
1;1;9000;1;
1;1;9500;1;
