1;1;5000;1;
1;2;7000;1;
1;1;9000;1;
1;2;11000;0;
1;1;13000;0;
1;2;15000;1;
1;1;17000;1;
1;2;19000;0;
